aa	aa
ab	ab
ace	ace
ada	ada
ady	ady
af	af
agq	agq
ain	ain
ak	ak
ale	ale
alt	alt
an	an
anp	anp
arn	arn
arp	arp
asa	asa
ast	ast
av	av
awa	awa
ay	ay
az	az
ba	ba
ban	ban
bas	bas
bem	bem
bez	bez
bho	bho
bi	bi
bin	bin
bla	bla
bm	bm
bn	bn
bo	bo
br	br
brx	brx
bug	bug
byn	byn
ca	ca
ce	ce
ceb	ceb
cgg	cgg
ch	ch
chk	chk
chm	chm
cho	cho
chr	chr
chy	chy
ckb	ckb
co	co
crs	crs
cs	cs
cu	cu
cv	cv
cy	cy
da	da
dak	dak
dar	dar
dav	dav
dgr	dgr
dje	dje
dsb	dsb
dua	dua
dv	dv
dyo	dyo
dz	dz
dzg	dzg
ebu	ebu
ee	ee
efi	efi
eka	eka
eo	eo
es	es
es-419	es (419)
es-MX	es (MX)
es-ES	es (هسپانیه)
ewo	ewo
ff	ff
fil	fil
fj	fj
fo	fo
fon	fon
fur	fur
fy	fy
ga	ga
gaa	gaa
gan	gan
gd	gd
gez	gez
gil	gil
gl	gl
gn	gn
gor	gor
gsw	gsw
gu	gu
guz	guz
gv	gv
gwi	gwi
ha	ha
hak	hak
haw	haw
hil	hil
hmn	hmn
hr	hr
hsb	hsb
hsn	hsn
ht	ht
hu	hu
hup	hup
hz	hz
ia	ia
iba	iba
ibb	ibb
id	id
ig	ig
ii	ii
ilo	ilo
inh	inh
io	io
is	is
iu	iu
jbo	jbo
jgo	jgo
jmc	jmc
jv	jv
ka	ka
kab	kab
kac	kac
kaj	kaj
kam	kam
kbd	kbd
kcg	kcg
kde	kde
kea	kea
kfo	kfo
kha	kha
khq	khq
ki	ki
kj	kj
kk	kk
kkj	kkj
kl	kl
kln	kln
km	km
kmb	kmb
kn	kn
ko	ko
kok	kok
kpe	kpe
kr	kr
krc	krc
krl	krl
kru	kru
ks	ks
ksb	ksb
ksf	ksf
ksh	ksh
kum	kum
kv	kv
kw	kw
ky	ky
lad	lad
lag	lag
lb	lb
lez	lez
lg	lg
li	li
lkt	lkt
ln	ln
lo	lo
loz	loz
lrc	lrc
lt	lt
lu	lu
lua	lua
lun	lun
luo	luo
lus	lus
luy	luy
lv	lv
mad	mad
mag	mag
mai	mai
mak	mak
mas	mas
mdf	mdf
men	men
mer	mer
mfe	mfe
mgh	mgh
mgo	mgo
mh	mh
mi	mi
mic	mic
min	min
ml	ml
mni	mni
moh	moh
mos	mos
mr	mr
mt	mt
mua	mua
mul	mul
mus	mus
mwl	mwl
my	my
myv	myv
mzn	mzn
na	na
nan	nan
nap	nap
naq	naq
nb	nb
nd	nd
nds-NL	nds (هالېنډ)
new	new
ng	ng
nia	nia
niu	niu
nmg	nmg
nn	nn
nnh	nnh
nog	nog
nqo	nqo
nr	nr
nso	nso
nus	nus
nv	nv
ny	ny
nyn	nyn
oc	oc
om	om
or	or
os	os
pa	pa
pag	pag
pam	pam
pap	pap
pau	pau
pcm	pcm
prg	prg
qu	qu
quc	quc
rap	rap
rar	rar
rm	rm
rn	rn
ro	ro
ro-MD	ro (MD)
rof	rof
root	root
rup	rup
rw	rw
rwk	rwk
sad	sad
sah	sah
saq	saq
sat	sat
sba	sba
sbp	sbp
sc	sc
scn	scn
sco	sco
sd	sd
se	se
seh	seh
ses	ses
sg	sg
shi	shi
shn	shn
si	si
sk	sk
sl	sl
sm	sm
sma	sma
smj	smj
smn	smn
sms	sms
sn	sn
snk	snk
so	so
sr	sr
srn	srn
ss	ss
ssy	ssy
st	st
su	su
suk	suk
sw	sw
sw-CD	sw (CD)
swb	swb
syr	syr
ta	ta
te	te
tem	tem
teo	teo
tet	tet
th	th
ti	ti
tig	tig
tlh	tlh
tn	tn
to	to
tpi	tpi
tr	tr
trv	trv
ts	ts
tum	tum
tvl	tvl
twq	twq
ty	ty
tyv	tyv
tzm	tzm
udm	udm
ug	ug
uk	uk
umb	umb
und	und
ur	ur
vai	vai
ve	ve
vi	vi
vo	vo
vun	vun
wa	wa
wae	wae
wal	wal
war	war
wo	wo
wuu	wuu
xal	xal
xh	xh
xog	xog
yav	yav
ybb	ybb
yi	yi
yo	yo
yue	yue
zgh	zgh
zu	zu
zun	zun
zxx	zxx
zza	zza
as	آسامي
hy	ارمني
uz	ازبکي
sq	الباني
de	الماني
de-AT	الماني (اتریش)
de-CH	الماني (سویس)
am	امهاري
en	انګریزي
en-AU	انګریزي (AU)
en-GB	انګریزي (GB)
en-US	انګریزي (US)
en-CA	انګریزي (کاناډا)
it	ایټالوي
eu	باسکي
bg	بلغاري
bal	بلوڅي
bs	بوسني
be	بېلاروسي
ps	پښتو
pt	پورتګالي
pt-BR	پورتګالي (BR)
pt-PT	پورتګالي (پورتګال)
pl	پولنډي
tt	تاتار
tg	تاجکي
tk	ترکمني
ja	جاپانی
zh	چیني
zh-Hans	چیني (Hans)
zh-Hant	چیني (Hant)
et	حبشي
ru	روسي
sa	سنسکریټ
sv	سویډنی
he	عبري
ar	عربي
ar-001	عربي (001)
fa	فارسي
fr	فرانسوي
fr-CH	فرانسوي (سویس)
fr-CA	فرانسوي (کاناډا)
fi	فینلنډي
ku	کردي
la	لاتیني
mn	مغولي
mk	مقدوني
ms	ملایا
mg	ملغاسي
ne	نېپالي
nl	هالېنډي
nl-BE	هالېنډي (BE)
hi	هندي
el	یوناني
