aa	aa
ae	ae
an	an
av	av
ay	ay
bi	bi
ch	ch
cr	cr
cu	cu
dv	dv
ff	ff
gd	gd
ho	ho
hz	hz
ia	ia
ie	ie
ik	ik
io	io
kg	kg
kj	kj
kr	kr
kv	kv
li	li
mh	mh
na	na
ng	ng
nr	nr
nv	nv
ny	ny
oc	oc
oj	oj
os	os
sc	sc
sh	sh
sm	sm
ss	ss
st	st
tl	tl
tn	tn
ts	ts
ty	ty
ve	ve
vo	vo
wa	wa
yi	yi
za	za
ug	ਉਇਗੁਰ
uz	ਉਜ਼ਬੇਕ
se	ਉੱਤਰੀ ਸਾਮੀ
nd	ਉੱਤਰੀ ਨਡੇਬੇਲੇ
ur	ਉਰਦੂ
or	ਉੜੀਆ
om	ਓਰੋਮੋ
as	ਅਸਾਮੀ
ak	ਅਕਾਨ
en	ਅੰਗਰੇਜ਼ੀ
az	ਅਜ਼ੇਰੀ
af	ਅਫ਼ਰੀਕੀ
ab	ਅਬਖਾਜ਼ੀਅਨ
am	ਅਮਹਾਰਿਕ
ar	ਅਰਬੀ
hy	ਅਰਮੀਨੀਆਈ
sq	ਅਲਬਾਨੀਆਈ
ga	ਆਇਰੀ
is	ਆਈਸਲੈਂਡਿਕ
et	ਇਸਟੋਨੀਆਈ
eo	ਇਸਪੇਰਾਂਟੋ
iu	ਇੰਕਟੀਟੂਤ
ig	ਇਗਬੋ
id	ਇੰਡੋਨੇਸ਼ੀਆਈ
it	ਇਤਾਲਵੀ
ee	ਈਵਈ
sa	ਸੰਸਕ੍ਰਿਤ
es	ਸਪੇਨੀ
sr	ਸਰਬੀਆਈ
sk	ਸਲੋਵਾਕ
sl	ਸਲੋਵੇਨੀਆਈ
sw	ਸਵਾਹਿਲੀ
sv	ਸਵੀਡਿਸ਼
sg	ਸਾਂਗੋ
si	ਸਿੰਹਾਲਾ
ii	ਸਿਚੁਆਨ ਯੀ
sd	ਸਿੰਧੀ
su	ਸੂੰਡਾਨੀ
sn	ਸ਼ੋਨਾ
so	ਸੋਮਾਲੀ
hu	ਹੰਗਰੀਆਈ
hi	ਹਿੰਦੀ
he	ਹਿਬਰੂ
ht	ਹੈਤੀਆਈ
ha	ਹੌਸਾ
ks	ਕਸ਼ਮੀਰੀ
qu	ਕਕੇਸ਼ੁਆ
kk	ਕਜ਼ਾਖ਼
kn	ਕੰਨੜ
kl	ਕਲਾਅੱਲੀਸੁਟ
ki	ਕਿਕੂਯੂ
rw	ਕਿਨਿਆਰਵਾਂਡਾ
ky	ਕਿਰਗੀਜ਼
ku	ਕੁਰਦ
ca	ਕੈਟਾਲਾਨ
co	ਕੋਰਸੀਕਨ
kw	ਕੋਰਨਿਸ਼
ko	ਕੋਰੀਆਈ
hr	ਕ੍ਰੋਏਸ਼ਿਆਈ
km	ਖਮੇਰ
xh	ਖੋਸਾ
lg	ਗਾਂਡਾ
gn	ਗੁਆਰਾਨੀ
gu	ਗੁਜਰਾਤੀ
gl	ਗੈਲਿਸ਼ਿਅਨ
zh	ਚੀਨੀ
cv	ਚੁਵਾਸ਼
ce	ਚੇਚਨ
cs	ਚੈਕ
ja	ਜਪਾਨੀ
de	ਜਰਮਨ
ka	ਜਾਰਜੀਆਈ
jv	ਜਾਵਾਨੀਜ਼
zu	ਜ਼ੁਲੂ
dz	ਜ਼ੋਂਗਖਾ
to	ਟੌਂਗਨ
nl	ਡੱਚ
da	ਡੈਨਿਸ਼
tt	ਤਤਾਰ
ta	ਤਮਿਲ
tg	ਤਾਜਿਕ
ti	ਤਿਗ੍ਰੀਨਿਆ
bo	ਤਿੱਬਤੀ
tk	ਤੁਰਕਮੇਨ
tr	ਤੁਰਕੀ
te	ਤੇਲਗੂ
tw	ਤ੍ਵਿ
th	ਥਾਈ
nn	ਨਾਰਵੇਜਿਆਈ ਨਿਓਨੌਰਸਕ
nb	ਨਾਰਵੇਜਿਆਈ ਬੋਕਮਲ
no	ਨਾਰਵੇਜੀਅਨ
ne	ਨੇਪਾਲੀ
ps	ਪਸ਼ਤੋ
fy	ਪੱਛਮੀ ਫ੍ਰਿਸੀਅਨ
pa	ਪੰਜਾਬੀ
pi	ਪਲੀ
pt	ਪੁਰਤਗਾਲੀ
pl	ਪੋਲੈਂਡੀ
fr	ਫਰਾਂਸੀਸੀ
fa	ਫ਼ਾਰਸੀ
fj	ਫ਼ਿਜ਼ੀ
fi	ਫਿਨਿਸ਼
fo	ਫ਼ੇਰੋਸੇ
ba	ਬਸ਼ਕੀਰ
bn	ਬੰਗਾਲੀ
bm	ਬੰਬਾਰਾ
my	ਬਰਮੀ
br	ਬਰੇਟਨ
eu	ਬਾਸਕ
bg	ਬੁਲਗਾਰੀਆਈ
be	ਬੇਲਾਰੂਸੀ
bs	ਬੋਸਨੀਆਈ
mn	ਮੰਗੋਲੀਅਨ
mr	ਮਰਾਠੀ
ms	ਮਲਯ
ml	ਮਲਿਆਲਮ
mi	ਮਾਉਰੀ
mt	ਮਾਲਟੀਜ਼
mg	ਮੇਲੇਗਸੀ
gv	ਮੈਂਕਸ
mk	ਮੈਕਡੋਨੀਆਈ
en-US	ਯੂ.ਐਸ. ਅੰਗਰੇਜ਼ੀ
en-GB	ਯੂ.ਕੇ. ਅੰਗਰੇਜ਼ੀ
uk	ਯੂਕਰੇਨੀਆਈ
el	ਯੂਨਾਨੀ
yo	ਯੋਰੂਬਾ
rn	ਰੁੰਡੀ
ru	ਰੂਸੀ
rm	ਰੋਮਾਂਸ਼
ro	ਰੋਮਾਨੀਆਈ
lb	ਲਕਜ਼ਮਬਰਗਿਸ਼
lo	ਲਾਓ
lv	ਲਾਟਵਿਅਨ
la	ਲਾਤੀਨੀ
ln	ਲਿੰਗਾਲਾ
lt	ਲਿਥੁਆਨੀਅਨ
lu	ਲੂਬਾ-ਕਾਟਾਂਗਾ
vi	ਵੀਅਤਨਾਮੀ
cy	ਵੈਲਜ਼
wo	ਵੋਲੋਫ
