aa	aa
ab	ab
ace	ace
ada	ada
ady	ady
af	af
agq	agq
ain	ain
ak	Akan
ale	ale
alt	alt
an	an
anp	anp
arn	arn
arp	arp
as	as
asa	asa
ast	ast
av	av
awa	awa
am	Axmaari
ay	ay
az	az
ba	ba
ban	ban
bn	Bangaali
bas	bas
be	Beleruusiyaan
bem	bem
bez	bez
bho	bho
bi	bi
bin	bin
bla	bla
bm	bm
bo	bo
pl	Boolish
pt	Boortaqiis
pt-PT	Boortaqiis (Bortuqaal)
pt-BR	Boortaqiis (Braasiil)
br	br
brx	brx
bs	bs
bug	bug
bg	Bulgeeriyaan
pa	Bunjaabi
my	Burmese
byn	byn
ca	ca
ar	Carabi
ar-001	Carabi (001)
ce	ce
ceb	ceb
cgg	cgg
ch	ch
chk	chk
chm	chm
cho	cho
chr	chr
chy	chy
ckb	ckb
co	co
crs	crs
cu	cu
cv	cv
cy	cy
da	da
dak	dak
dar	dar
dav	dav
dgr	dgr
dje	dje
dsb	dsb
dua	dua
dv	dv
dyo	dyo
dz	dz
dzg	dzg
ebu	ebu
ee	ee
efi	efi
eka	eka
eo	eo
et	et
eu	eu
ewo	ewo
fa	Faarisi
fr	Faransiis
fr-CA	Faransiis (Kanada)
fr-CH	Faransiis (Swiiserlaand)
ff	ff
fi	fi
vi	Fiitnaamays
fil	fil
fy	Firiisiyan Galbeed
fj	fj
fo	fo
fon	fon
fur	fur
ga	ga
gaa	gaa
gan	gan
gd	gd
gez	gez
gil	gil
el	Giriik
gl	gl
gn	gn
gor	gor
gsw	gsw
gu	gu
guz	guz
gv	gv
gwi	gwi
hak	hak
hu	Hangariyaan
haw	haw
ha	Hawsa
he	he
hil	hil
hi	Hindi
hmn	hmn
nl	Holandays
nl-BE	Holandays (Biljam)
hr	hr
hsb	hsb
hsn	hsn
ht	ht
hup	hup
hy	hy
hz	hz
ia	ia
iba	iba
ibb	ibb
ig	Igbo
ii	ii
ilo	ilo
id	Indunuusiyaan
en	Ingiriisi
en-AU	Ingiriisi (Awstaraaliya)
en-GB	Ingiriisi (GB)
en-CA	Ingiriisi (Kanada)
en-US	Ingiriisi (US)
inh	inh
io	io
is	is
es	Isbaanish
es-419	Isbaanish (419)
es-ES	Isbaanish (Isbeyn)
es-MX	Isbaanish (Meksiko)
iu	iu
ja	Jabbaaniis
jv	Jafaaniis
de	Jarmal
de-AT	Jarmal (Awsteriya)
de-CH	Jarmal (Swiiserlaand)
zh	Jayniis
zh-Hans	Jayniis (Hans)
zh-Hant	Jayniis (Hant)
jbo	jbo
cs	Jeeg
jgo	jgo
jmc	jmc
ka	ka
kab	kab
kac	kac
kaj	kaj
kam	kam
km	Kamboodhian
kbd	kbd
kcg	kcg
kde	kde
kea	kea
kfo	kfo
kha	kha
khq	khq
ki	ki
kj	kj
kk	kk
kkj	kkj
kl	kl
kln	kln
kmb	kmb
kn	kn
kok	kok
kpe	kpe
kr	kr
krc	krc
krl	krl
kru	kru
ks	ks
ksb	ksb
ksf	ksf
ksh	ksh
ku	ku
kum	kum
ko	Kuuriyaan
kv	kv
kw	kw
ky	ky
la	la
lad	lad
lag	lag
lb	lb
lez	lez
lg	lg
li	li
lkt	lkt
ln	ln
lo	lo
loz	loz
lrc	lrc
lt	lt
lu	lu
lua	lua
lun	lun
luo	luo
lus	lus
luy	luy
lv	lv
mad	mad
mag	mag
mai	mai
mak	mak
ms	Malaay
mas	mas
mdf	mdf
men	men
mer	mer
mfe	mfe
mg	mg
mgh	mgh
mgo	mgo
mh	mh
mi	mi
mic	mic
min	min
mk	mk
ml	ml
mn	mn
mni	mni
moh	moh
mos	mos
mr	mr
mt	mt
mua	mua
mul	mul
mus	mus
mwl	mwl
myv	myv
mzn	mzn
na	na
nan	nan
nap	nap
naq	naq
nb	nb
nd	nd
nds-NL	nds (Netherlands)
ne	Nebaali
new	new
ng	ng
nia	nia
niu	niu
nmg	nmg
nn	nn
nnh	nnh
nog	nog
nqo	nqo
nr	nr
nso	nso
nus	nus
nv	nv
ny	ny
nyn	nyn
oc	oc
om	om
or	or
os	os
pag	pag
pam	pam
pap	pap
pau	pau
pcm	pcm
prg	prg
ps	ps
qu	qu
quc	quc
rap	rap
rar	rar
rm	rm
rn	rn
rof	rof
ro	Romanka
ro-MD	Romanka (Moldofa)
root	root
rup	rup
ru	Ruush
rw	Rwanda
rwk	rwk
sa	sa
sad	sad
sah	sah
saq	saq
sat	sat
sba	sba
sbp	sbp
sc	sc
scn	scn
sco	sco
sd	sd
se	se
seh	seh
ses	ses
sg	sg
shi	shi
shn	shn
si	si
sk	sk
sl	sl
sm	sm
sma	sma
smj	smj
smn	smn
sms	sms
sn	sn
snk	snk
so	Soomaali
sq	sq
sr	sr
srn	srn
ss	ss
ssy	ssy
st	st
su	su
suk	suk
sw	sw
sw-CD	sw (Jamhuuriyadda Dimuquraadiga Kongo)
swb	swb
sv	Swiidhis
syr	syr
th	Taaylandays
it	Talyaani
ta	Tamiil
te	te
tem	tem
teo	teo
tet	tet
tg	tg
ti	ti
tig	tig
tk	tk
tlh	tlh
tn	tn
to	to
tpi	tpi
trv	trv
ts	ts
tt	tt
tum	tum
tr	Turkish
tvl	tvl
twq	twq
ty	ty
tyv	tyv
tzm	tzm
udm	udm
ug	ug
umb	umb
und	und
ur	Urduu
uz	uz
vai	vai
ve	ve
vo	vo
vun	vun
wa	wa
wae	wae
wal	wal
war	war
wo	wo
wuu	wuu
xal	xal
xh	xh
xog	xog
yav	yav
ybb	ybb
yi	yi
yo	Yoruuba
yue	yue
uk	Yukreeniyaan
zgh	zgh
zun	zun
zu	Zuulu
zxx	zxx
zza	zza
